11111111111111111111111111111
1P00000000001100000000001E011
11110R111101C00011000C0010011
10000000110111001100000010R11
10011100110000000111111110001
100111001100110011C0000000001
1R000000110011001111111111101
1000C000000C11000000000000001
11111111111111111111111111111